19   15
1   1
9004    9004    9004    9004    9004    9004    9004    9004    9004    9004    9004    9004    9004    9004    9004    9004    9004    9004    9004
9004    9001    9001    9001    9001    9001    9001    9001    9001    9001    9001    9001    9001    9001    9001    9001    9001    9001    9004
9004    9001    9001    9001    9001    9001    9001    9001    9001    9006    9001    9001    9001    9001    9001    9001    9001    9001    9004
9004    9001    9001    9001    9001    9001    9001    9001    9004    9006    9004    9001    9001    9001    9001    9001    9001    9001    9004
9004    9001    9001    9001    9001    9001    9001    9004    9006    9006    9006    9004    9001    9001    9001    9001    9001    9001    9004
9004    9001    9001    9001    9001    9001    9001    9001    9004    9006    9004    9001    9001    9001    9001    9001    9001    9001    9004
9004    9001    9001    9001    9001    9001    9001    9001    9003    9006    9003    9001    9001    9001    9001    9001    9001    9001    9004
9004    9001    9001    9001    9001    9001    9001    9006    9006    9006    9006    9006    9001    9001    9001    9001    9001    9001    9004
9004    9001    9001    9001    9001    9001    9003    9003    9003    9006    9003    9003    9003    9001    9001    9001    9001    9001    9004
9004    9001    9001    9001    9001    9006    9006    9006    9006    9006    9006    9006    9006    9006    9001    9001    9001    9001    9004
9004    9001    9001    9001    9003    9003    9003    9003    9003    9006    9003    9003    9003    9003    9003    9001    9001    9001    9004
9004    9001    9001    9006    9006    9006    9006    9006    9006    9006    9006    9006    9006    9006    9006    9006    9001    9001    9004
9004    9001    9003    9003    9003    9003    9003    9003    9003    9006    9003    9003    9003    9003    9003    9003    9003    9001    9004
9004    9006    9006    9006    9006    9006    9006    9006    9006    9006    9006    9006    9006    9006    9006    9006    9006    9006    9004
9004    9004    9004    9004    9004    9004    9004    9004    9004    9004    9004    9004    9004    9004    9004    9004    9004    9004    9004