13  13
1   1
9004    9004    9004    9004    9004    9004    9004    9004    9004    9004    9004    9004
9004    9001    9001    9001    9001    9001    9001    9001    9001    9001    9001    9004
9004    9001    9001    9001    9004    9004    9004    9004    9001    9001    9001    9004
9004    9001    9001    9001    9004    9004    9004    9004    9001    9001    9001    9004
9004    9001    9004    9004    9004    9004    9004    9004    9004    9004    9001    9004
9004    9001    9004    9004    9004    9004    9004    9004    9004    9004    9001    9004
9004    9001    9004    9004    9004    9004    9004    9004    9004    9004    9001    9004
9004    9001    9004    9004    9004    9004    9004    9004    9004    9004    9001    9004
9004    9001    9004    9004    9004    9004    9004    9004    9004    9004    9001    9004
9004    9001    9001    9001    9004    9004    9004    9004    9001    9001    9001    9004
9004    9001    9001    9001    9004    9004    9004    9004    9001    9001    9001    9004
9004    9001    9001    9001    9001    9001    9001    9001    9001    9001    9001    9004
9004    9004    9004    9004    9004    9004    9004    9004    9004    9004    9004    9004